...###.....
..##.######
.##.......#
##........#
#...@.....#
#.........#
#.........#
#.........#
#.........#
#.........#
###########