###########
#.........#
#..#.#.#..#
#.........#
#..#@.....#
#.....#...#
#.........#
#....#....#
###.......#
#.........#
###########